@########
*#*****##
*##*##*##
*#**##**#
*#****#*#
*#*#*#**#
*#*##**##
****!**##
**##***?#
####*####
