@########
*******##
###*##*##
****##*##
##****#*#
*#*#*##**
*#*##*###
****#*###
**#****?#
####*####
