@########
**#******
#********
####**###
#****!#**
#*#***#**
#!**!****
#**#**#!*
###**!#*!
####****?