****#***#
#@#*#*#*#
#*!***#*#
#*##*#***
#*#**#*#*
#**#**!**
#**#*#**#
#**#*##**
#***!***#
#**#*##*?