@********
#*##*****
#***##***
##!******
#**###***
#******##
#**##**##
#*#*!*#**
#***#*!##
#*##!***?